NO ./textures/path_north_texture.png
SO ./textures/path_south_texture.png
WE ./textures/path_west_texture.png    
EA ./textures/path_east_texture.png       

F 220,100,0
C 255,255,255

   111 111 1111
1111011111111
1000011111N111
10100111111111
11001 10111111
111111111




