NO ./textures/path_north_texture.png
SO ./textures/path_south_texture.png
WE ./textures/path_west_texture.png
EA ./textures/path_east_texture.png

F 220,100,0
C 255,255,255

1111111111
1100000001
1000000001
10000N0001
1111111111
