NO ./textures/path_north_texture.xpm
SO ./textures/path_south_texture.xpm
WE ./textures/path_west_texture.xpm
EA ./textures/path_east_texture.xpm

F 220,100,0
C 135,206,235

        1111111111
1111111100000000011
1000000001111000001  
10000000011100W001
1111111111 111111