NO ./textures/path_north_texture.xpm
SO ./textures/path_south_texture.xpm
WE ./textures/path_west_texture.xpm    
EA ./textures/path_east_texture.xpm       

F 220,100,0
C 135,206,235

   111 111 1111
1111011111111
1000011111N111
10100111111111
11001 1011111
111111111 111